13
17
______OO___##
__##O_O______
___O___#T#_O_
___________O_
__OO_H____H#_
____C______H_
__H__CC_CH_H_
_____#_____T_
______CTCT___
____H_#TCCOC_
T_C_____H_TTO
_TH___TT_h___
_______TO____
_O___O_OC____
__#T___C_H__#
_______#___#C
_____H____T__
