14
14
C_OTHT#T____O_
TTCO#_C#CC__CC
TTT_OOC_C____T
_TH_#OH___HHH_
____THO____C__
_#___________H
H_#T_O__O_OT_H
TCC__CTT__C___
____#__THH____
#__HhC_HTC_H_H
_H_TCC#___CH_H
#_HO____#_HT__
__C#__HOO__HC_
____CCTOtHT_HH
